#######
#  @  #
# $   #
# $ . #
# $...#
#     #
#######