######
#    #
# $. #
# .$ #
#  @ #
######