#######
#  .  #
# $ $ #
# @.  #
#   $ #
#   . #
#######