#######
#     #
# .$@ #
#     #
#######