#######
#.    #
# $   #
#   @ #
#######