 #####
##   #
# $@ #
# $  #
# .. #
#    #
######