########
#   @  #
# $ $  #
## . . #
 #  $  #
 #  .  #
 ########