#######
#  @  #
# $   #
## .$ #
 # .  #
 ######